################
..............+#
#.### #####....#
. ..#.#...#....#
###.#.#.G. ..  #
....#.#####.   #
 .#.#.......##.#
 #############.#
..#        .## #
& # #### ## #..#
#.# #.    #.#..#
..# #.#.S.#.#.##
 .# #.#####.#..#
.##.#.......#..#
 .#           .#
################
 ..............#
...............#               
#.### #####....#
. ..#.#...#....#
###.#.#. .#....#
....#.#####.   #
 .#.#.......##.#
 #############.#
..#        .##.#
. # ####### #..#
#.# #.  G #.#..#
..# #.#...#.#.##
 .# #.#####.#..#
.##.#.......#..#
 .#           .#
################